1111111111111111111111111111111111
1E00000C00000000000000000000000001
10100101001000001010010000000101C1
1010010010101010001001000000010101
1P0000000000000C000000000000000001
1111111111111111111111111111111111
