111111111111111111111111111
1E00000C0000000000000000001
1010010100111001000000101C1
101001001011110100000010101
1P0000000000C00000000000001
111111111111111111111111111
