11111111111111111111
1E0000001000000000C1
1C111100100111111101
1010C1001001C010C101
10100100100100100101
10100100000100100101
10100100000100100101
10100100100100100101
10100100100100100101
100001C0100100100101
100001001001001C0101
10100100100100100101
10100100100100100101
10100100100100100101
10100100100000100101
10100100100000100101
10100100100100100101
10100100100100100101
1P0000001C0100000001
11111111111111111111
