111111
1P00C1
101101
101101
1E00C1
111111
